x-------x,
x-------x
|
|
|
|
|,
x-------x
|       |
|       0
|
|
|,
x-------x
|       |
|       0
|       |
|
|,
x-------x
|       |
|       0
|      \|/
|
|,
x-------x
|       |
|       0
|      \|/
|      \
|,
x-------x
|       |
|       0
|      \|/
|      \ /
|
